**###***#*
###*##***#
*##*#***##
***##*****
*****#***#
G#****#***
**#****#*#
#****#****
*#*******#
*##***##*S